111111111111111
11110000C0000C1
111100C0000P001
100001111110001
1101111E1111111
1000C0000000001
111111111111111
