111111111111
1E0C000C00P1
111111111111