111111111111111
1EPCCCCCCCCCC01
111111111111111