111111111111111
1E1C1000C0011C1
1CC000C0000P001
110001111111101
1000000C011C001
1011C000C1111C1
1C1111110000001
111111111111111