1111111111111111111111111111111111
1000000000000000000000000000000001
1000011111000000000000000000000001
100010CCC01000000000001111000000C1
100100CCC0011111111111000011000C01
100100000000000000000000000010C001
100100CCCCCCCCCCCCCCCCCCCCCCCCC0C1
100100000000000000000000000010C001
100100CCC0011111111111000011000C01
100010CCC01000000000001111000000C1
1000011111000000000000000000000001
1000000000000000000000000000000001
1111111111111111111111111111111111