1111111111
1CE00000P1
1111111111